018 018 018 018 018 018 012 016 008 008 016 012 018 018 018 018 018 
018 012 012 012 012 012 012 016 016 016 016 012 018 018 018 018 018 
018 012 010 010 010 012 012 016 008 008 016 012 012 012 012 012 012 
018 012 010 010 010 012 012 016 008 008 016 016 016 016 016 016 016 
018 012 010 010 010 012 012 016 008 008 008 008 008 016 008 008 008 
012 012 012 010 012 012 012 016 008 008 008 008 008 016 008 008 008 
016 016 016 016 016 016 016 016 008 008 016 016 016 016 016 016 016 
008 008 008 008 008 008 008 008 008 008 016 012 012 012 012 012 012 
008 008 008 008 008 008 008 008 008 008 016 012 018 018 018 018 018 
016 016 016 016 016 016 016 016 008 008 016 012 018 018 018 018 018 
012 012 012 012 012 012 012 016 008 008 016 012 018 018 018 018 018 
018 018 018 018 018 018 012 016 008 008 016 012 018 018 018 018 018 
018 018 018 018 018 018 012 016 008 008 016 012 018 018 018 018 018 
018 018 018 018 018 018 012 016 008 008 016 012 018 018 018 018 018 
018 018 018 018 018 018 012 016 008 008 016 012 018 018 018 018 018 
018 018 018 018 018 018 012 016 008 008 016 012 018 018 018 018 018 
018 018 018 018 018 018 012 016 008 008 016 012 018 018 018 018 018 
