004 004 004 004 004 004 004 004 004 004 004 004 001 001 001 001 001 
004 002 004 004 004 004 004 004 001 001 001 001 001 001 001 001 001 
004 004 004 004 002 004 004 004 004 004 001 001 001 001 002 001 001 
004 004 004 004 004 004 004 004 004 002 004 001 001 001 001 001 001 
004 004 004 004 004 004 004 004 004 004 004 001 001 001 001 001 001 
004 004 002 004 004 002 004 004 004 004 004 001 001 001 001 001 001 
004 004 004 004 004 004 004 004 004 004 004 001 002 001 001 001 001 
004 004 004 004 004 004 004 002 004 004 004 001 001 001 001 001 001 
004 004 004 004 002 004 004 004 004 004 004 004 004 004 001 001 001 
004 004 004 004 004 004 004 002 004 004 004 002 004 004 002 001 001 
004 004 004 004 004 004 004 004 004 004 004 004 004 004 004 001 004 
004 002 004 004 004 004 004 004 004 004 004 004 004 004 004 004 004 
004 004 004 004 004 004 004 002 004 004 004 004 004 004 002 004 004 
004 004 002 004 004 004 004 004 004 003 003 004 002 004 004 004 004 
004 004 004 004 002 004 004 004 003 003 003 003 004 004 004 004 004 
004 004 004 004 004 004 004 003 003 003 003 004 004 004 004 004 004 
004 004 004 004 004 004 004 003 004 003 004 004 004 004 004 004 004 
