005 005 005 005 005 005 005 005 005 005 005 005 005 005 005 003 005 
005 005 005 005 005 005 005 005 005 005 005 005 005 005 003 003 005 
005 005 003 003 005 005 005 005 005 003 005 005 005 005 003 005 005 
005 005 005 005 005 005 005 005 005 005 003 005 005 005 005 005 005 
005 005 005 005 005 005 005 005 005 005 005 005 005 005 003 005 005 
005 005 003 005 005 005 005 005 005 005 005 005 005 003 005 005 005 
005 003 005 005 005 003 005 005 005 005 005 005 005 003 005 005 005 
005 005 005 005 005 005 005 005 005 005 005 005 005 005 005 005 005 
005 005 005 005 005 005 005 005 005 005 005 005 005 005 005 005 005 
005 005 005 003 005 005 005 005 005 005 005 005 005 005 005 005 005 
005 005 005 005 005 005 005 003 005 005 005 005 008 008 005 005 005 
005 005 005 005 005 005 003 005 005 005 005 008 008 008 008 005 005 
005 003 005 005 005 003 003 005 005 005 008 008 008 008 008 005 005 
005 003 005 005 005 003 005 005 005 008 008 008 005 005 008 008 008 
005 005 005 005 005 005 005 005 005 008 008 008 005 002 005 008 008 
005 005 005 005 005 005 005 005 005 005 008 008 005 005 008 008 008 
005 005 005 005 005 005 005 005 005 005 005 008 008 008 008 008 008 
