007 007 014 009 009 009 003 003 008 008 008 008 008 008 008 008 008 
007 007 007 009 009 009 009 003 008 008 008 008 008 008 008 008 008 
014 007 007 007 009 009 009 009 009 008 008 008 008 008 008 008 008 
009 007 007 007 007 009 009 009 009 008 008 008 008 008 008 008 008 
009 009 007 007 007 009 009 009 009 009 008 008 008 008 008 008 008 
009 009 014 007 007 009 009 009 009 009 009 009 003 008 008 008 008 
009 009 009 007 007 007 009 009 009 009 009 009 009 003 003 008 008 
009 009 009 007 007 014 009 009 009 009 009 009 009 009 009 009 009 
009 009 007 007 007 009 009 009 009 009 009 009 009 009 009 009 009 
009 009 007 007 007 014 009 009 009 009 009 009 009 009 009 009 009 
009 014 007 007 007 014 009 009 009 009 009 009 009 009 009 009 009 
009 009 007 007 007 007 014 009 009 009 009 009 009 009 009 009 009 
009 009 014 007 007 007 007 007 009 009 009 009 009 009 009 009 009 
009 009 009 009 014 007 007 007 007 014 009 009 009 009 009 009 009 
009 009 009 009 009 014 007 007 007 007 014 009 009 009 009 009 009 
009 009 009 009 009 009 009 007 007 007 007 009 009 009 009 009 009 
009 009 009 009 009 009 009 014 007 007 007 007 014 009 009 009 009 
