011 011 011 011 011 011 011 011 011 011 011 011 011 010 010 011 011 
011 002 002 002 011 011 011 011 011 011 011 011 011 010 010 011 011 
011 011 011 011 011 011 011 011 011 011 011 011 011 010 010 011 011 
011 011 011 011 011 011 011 011 011 011 002 011 011 010 010 011 011 
011 011 011 012 012 012 012 012 012 012 012 002 011 010 010 011 011 
011 011 011 012 016 016 016 016 016 016 012 011 011 010 010 011 011 
011 011 002 012 016 016 016 016 016 016 012 011 011 010 010 011 011 
011 011 002 012 016 016 016 016 016 016 012 011 011 010 010 011 011 
011 002 011 012 012 012 012 011 012 012 012 011 011 010 010 011 011 
011 011 011 011 011 011 011 011 011 011 011 011 011 010 010 011 011 
010 010 010 010 010 010 010 010 010 010 010 010 010 010 010 011 011 
011 011 011 011 011 011 011 011 011 011 011 002 011 010 010 011 011 
011 011 011 002 015 015 015 015 015 015 015 015 011 010 010 011 011 
011 011 011 002 015 016 016 016 015 016 016 015 011 010 010 011 011 
011 011 011 011 016 016 016 016 016 016 016 015 011 010 010 011 002 
011 002 011 011 015 015 015 015 015 015 015 015 011 010 010 011 002 
011 011 002 011 011 011 011 011 011 011 011 011 011 010 010 011 011 
