013 013 013 013 013 013 013 013 013 013 013 013 013 013 013 013 013 
010 010 010 010 010 010 010 010 010 010 010 010 010 010 010 010 010 
010 010 010 010 010 010 010 010 010 010 010 010 010 010 010 010 010 
013 013 013 013 013 013 013 013 013 013 013 013 013 013 013 013 013 
013 013 013 013 013 013 013 003 013 013 013 013 013 013 013 013 013 
013 013 013 013 013 013 008 008 008 008 003 013 013 013 013 013 013 
013 013 013 013 003 008 008 008 008 008 008 013 013 013 013 013 013 
013 013 013 013 008 008 008 008 008 008 008 008 013 013 013 013 013 
013 013 013 013 008 008 008 008 008 008 008 008 003 013 013 013 013 
013 013 003 008 008 008 008 008 008 008 008 008 013 013 013 013 013 
013 013 013 013 008 008 008 008 008 008 008 008 013 013 013 013 013 
013 013 013 003 008 008 008 008 008 008 008 008 013 013 013 013 013 
013 013 013 013 013 008 008 008 008 008 008 003 013 013 013 013 013 
013 013 013 013 013 003 013 013 013 013 013 013 013 013 013 013 013 
013 013 013 013 013 013 013 013 013 013 013 013 013 013 013 013 013 
013 013 013 013 013 013 013 013 013 013 013 013 013 013 013 013 013 
013 013 013 013 013 013 013 013 013 013 013 013 013 013 013 013 013 
