005 005 005 005 005 005 005 005 005 005 005 005 005 005 008 008 008 
005 005 005 005 005 005 005 006 005 005 005 005 005 005 005 008 008 
005 005 005 005 005 005 005 005 005 005 006 005 005 005 005 005 008 
005 005 005 005 006 005 005 005 005 005 005 005 005 008 005 005 005 
005 005 005 008 005 005 005 005 005 005 005 005 008 008 005 005 005 
005 005 008 008 008 005 005 005 006 005 005 005 008 008 005 005 005 
005 005 005 005 008 005 005 005 005 005 005 005 005 005 005 005 005 
005 005 006 005 005 005 006 005 005 006 005 005 005 005 005 006 005 
005 005 005 005 005 005 005 005 005 005 005 005 005 005 005 005 005 
005 005 005 005 005 005 005 005 005 005 005 005 006 005 005 005 005 
005 005 005 005 006 005 005 005 006 005 005 005 005 005 005 005 005 
005 005 005 005 005 005 005 005 005 005 005 005 005 005 008 005 005 
005 005 006 005 005 005 005 005 005 005 006 005 008 008 008 005 005 
005 005 005 005 005 005 006 005 005 005 005 005 008 008 008 005 005 
005 005 005 005 005 005 005 005 005 005 005 005 005 008 008 005 005 
005 005 005 005 005 005 005 005 005 005 005 005 006 005 005 005 005 
005 005 005 005 005 005 005 005 005 005 005 005 005 005 005 005 005 
