002 002 002 002 002 002 002 002 002 002 002 002 002 002 002 002 002 
002 002 002 002 002 002 002 003 002 002 002 002 002 002 002 002 002 
002 002 002 002 002 002 002 002 002 002 002 002 002 002 002 002 002 
002 002 002 002 002 002 002 002 002 002 002 002 002 002 002 002 002 
002 002 003 003 002 002 002 002 002 002 002 003 002 002 002 002 002 
002 002 002 003 002 002 002 002 002 002 002 002 002 002 002 002 002 
002 002 002 002 002 002 002 002 002 002 002 002 002 002 014 002 002 
002 002 003 002 002 002 002 002 002 003 002 002 002 002 014 014 014 
002 002 002 002 002 002 002 002 002 002 002 002 002 002 002 014 002 
002 002 002 002 002 003 002 002 002 002 002 003 002 002 002 014 002 
002 002 002 002 002 002 002 002 002 002 003 003 003 002 002 002 002 
002 002 002 002 002 002 002 002 002 002 002 002 002 002 002 002 002 
002 002 002 003 002 002 002 002 002 002 002 002 002 002 002 002 002 
009 002 002 002 002 002 002 002 002 002 002 003 002 002 002 002 002 
009 009 009 002 002 002 002 002 003 002 002 002 002 002 002 002 002 
009 009 009 009 009 002 002 002 002 002 002 002 002 002 002 002 002 
009 009 009 009 009 002 002 002 002 002 002 002 002 002 002 002 002 
