003 003 003 003 003 003 003 003 003 003 003 003 003 003 005 005 005 
005 003 003 003 003 003 003 003 003 003 003 003 014 005 005 005 005 
005 005 014 003 003 003 003 003 003 003 003 003 014 005 005 005 005 
005 005 005 003 003 003 003 003 003 003 003 005 005 005 005 005 003 
005 005 005 003 003 014 003 003 003 003 005 005 005 005 005 005 003 
003 003 005 005 005 005 005 003 003 003 005 005 005 005 003 003 003 
003 003 005 005 005 005 005 003 003 005 005 005 005 014 003 003 003 
003 003 014 005 005 005 005 003 014 005 005 003 003 003 003 003 003 
003 003 003 003 005 005 005 005 005 005 005 003 003 003 003 003 003 
003 003 003 003 005 005 008 008 005 005 005 003 003 003 003 003 003 
003 003 003 014 005 005 008 008 005 005 005 005 003 003 003 003 003 
003 003 003 003 003 005 005 005 005 003 003 003 003 003 003 003 003 
003 003 003 003 003 003 005 005 005 005 003 003 003 003 003 003 003 
003 003 003 003 003 003 003 005 005 005 005 014 003 003 003 003 003 
003 003 003 003 003 003 014 003 005 005 005 005 003 003 003 003 003 
003 003 003 003 003 003 003 003 003 005 005 005 014 003 003 003 003 
003 003 003 003 003 003 003 003 003 003 014 005 005 005 003 003 003 
